"a" = (/turf/simulated/floor/jungle/king/grass,/area/jungle)
"b" = (/obj/structure/flora/ausbushes/fullgrass,/turf/simulated/floor/jungle/king/grass,/area/jungle)
"c" = (/obj/structure/flora/tree/jungle/small,/turf/simulated/floor/jungle/king/grass,/area/jungle)
"d" = (/obj/structure/flora/tree/jungle/large,/turf/simulated/floor/jungle/king/grass,/area/jungle)
"e" = (/obj/effect/decal/jungle/king/flower,/turf/simulated/floor/jungle/king/grass,/area/jungle)
"f" = (/obj/structure/flora/ausbushes/grassybush,/turf/simulated/floor/jungle/king/grass,/area/jungle)
"g" = (/obj/structure/flora/ausbushes/ywflowers,/turf/simulated/floor/jungle/king/grass,/area/jungle)
"h" = (/mob/living/simple_animal/fox,/turf/simulated/floor/jungle/king/grass,/area/jungle)
"i" = (/obj/effect/decal/jungle/king/flower/pink,/turf/simulated/floor/jungle/king/grass,/area/jungle)
"j" = (/mob/living/simple_animal/hostile/wolf,/turf/simulated/floor/jungle/king/grass,/area/jungle)
"k" = (/turf/simulated/floor/jungle/king/cobble/teleport2,/area/jungle)
"l" = (/turf/simulated/floor/jungle/king/cobble,/area/jungle)
"m" = (/obj/structure/flora/ausbushes/grassybush,/mob/living/simple_animal/hostile/wolf,/turf/simulated/floor/jungle/king/grass,/area/jungle)
"n" = (/obj/structure/flora/ausbushes/fullgrass,/mob/living/simple_animal/hostile/wolf,/turf/simulated/floor/jungle/king/grass,/area/jungle)
"o" = (/obj/structure/flora/tree/jungle/small,/mob/living/simple_animal/hostile/wolf,/turf/simulated/floor/jungle/king/grass,/area/jungle)
"p" = (/obj/structure/flora/ausbushes/fullgrass,/turf/simulated/floor/jungle/king/cobble,/area/jungle)
"q" = (/obj/effect/decal/jungle/king/flower,/mob/living/simple_animal/hostile/wolf,/turf/simulated/floor/jungle/king/grass,/area/jungle)
"r" = (/obj/item/clothing/ring/reagent/sleepy,/obj/structure/flora/ausbushes/fullgrass,/obj/structure/flora/ausbushes/ywflowers,/turf/simulated/floor/jungle/king/grass,/area/jungle)
"s" = (/obj/structure/flora/ausbushes/grassybush,/turf/simulated/floor/jungle/king/grass,/area/space)

(1,1,1) = {"
aaaaaaaaabaaabaaaaaaaaaaaaaaaaaaaaaaaaaaaaabaaaaaaaaaaaaaaaaaaaaaaaaaaaaaaaaaaaaaaaaaaaacdaaaaaacacc
ababbaabbaaaaaaaaaaaaaaaaaaaaaaabaaaaaaaaaaaaaaaaaaaaaaaaaaaaaaaaaaaaaaaaaaaaaaaaaaaaaaaadcaaccaacaa
babbaaabcabaaaacaaaaacaaaaaaacaababbeafaaaaaaaaaababacaaaaaacaffaceeaaaaaaacaaaaaaaacaacaaaacaaaaaaa
baaacbbababaaacaaaaaaaeaaaabaaacabbaaaafbaaaaaaacgbaaaaaabaaaaaaaaaeacaaaaaaaaaaacaaaacaaacaahaaaaca
baaaabbabaaaaaabaaaabbaacffaacaaabbaaaaaaafaaaaaaaaabaaaaeaaaaaacaaaeaacaaaaacafaaacaaaacaaccaaacaca
bbbaaabaaabcababbcaabbeadaaabaacaabaaabaaacaabdaaaaabgcaaaaacaaaaafaaaaaaaacaaacaaaaaacaaaabaaaaaaaa
aaaabbababbaaababbcaabbaaaabfacaacabaacacaaaabbaaacaaaaaaaaaaacaabacaaaaaaaaaaaaacaaaaaaaaaaaacaaaaa
adaaaaabacbbbeeaabeaaabbbaeaaacbaaaababaaaaabacbaaaaafaaaaaaacaacacaaacaaaaaacaaaaaacabcaaaaaaiaaaca
bbaaacbbabaaabbaaeaaababcbaaaaajacafaaabaaaacbaeaaaaaaaacaacaaaaaaacjacacfeaaaabaaaaaababaacaaaaaaaa
aabbaaaaaaafbabbbbggcaaaabaaaaabaaaafaaacaaabbbbejjabaaaaaababacaaacaaaaaacacaaaaaaaaabaaaaaaaafcaaa
kllaaaabaabaacbabbaaaaaaaacaaaaacaacfbbaabaaaaaabaaaaaaaaaaaajcaeaaaaaaaaaaaaaaaabaaaaaaaaiaacaaaaaa
klllllabcaaaaaacaabaaagaaaebbaaabaaaacaaaaaabaabaabaaacaacaaaaaaacaaaacaabcaaaaaaaacaabaaaaaaaeaaaba
allllllaabcaaabcaabaabbaaaaeabbaaabaababaaaaaacaaacbaaaaaaaacaadbaaacaaacaaaacaaafaaacaacaaaaaaabfaa
aaaallllaaabbaaabbabababcadabbbabbcabaebbaacaabcbbbaaaaabaaaaaabaaajagaaafaacaacaaaaaaaaaabaaabacaaa
affaallllllabbaaabbbabbabbbaabaabbbabbaaabaabbaaacadaaabaababaeaaabbcbaaaacaaaadacaaaaaabeaacaabbaaa
aabaaaallllllaabbaabbaabbbbbbabbgaaacbfbbaababbbabaamaaaaacaaacaacfabaaaaacbcbcacaaaaafaaaaaaabbacab
baaafababbllllladbaabacbabcabbaaabaaababacaaaabaaaabbbaacaaaaaaaaaaaaaaaaaaaaaaaaacaaaacfaaiaeaaabba
baabbabaabballlllabaaaabababfabbbbbaaaeabbabababaababbaaeaaabaaaaaaaaaacbaaaaacaaabaaeaaaaafaaaabaaa
aacbababaabaaalllllaabaabaaaaabbaabbaafcbfaabbcaacaaaacaaaaaaabaaaaaaaaaaaabgeaacaaaacbcaaaaafcabeaa
eabacafbbbaacaaalllllaaaaababbcbcbbcaaabcaabbbabcbaacbaaaaaaabaaaacfcaaaacbaaaaaaaaaaaaaacaaaaaaaaaa
aabaaaaabbbaaaaballlllllaabaabcaacaaaaaabfaaaababbcaaacaaaaanbaafaaaaabaaaacaaabaaaaaacaaaacaaaaaaaa
edbaaaacabbffaabaaalllllllllaaaacaacbbaaaadabcaebbbbaabaaacabbbcaaaaaafaeaoaaacaaaobabaacaaaacaaaaaa
bbabaaaaabbbbaaaabbaallllllllaabbabaababcaababaacgbabbaaeaaaaabbbabacabaabaaaabbcaaaaaaaaacbaaacaaaa
babbabdaaaffbfbaaababaalllllllllaaabbaabbaaaaaaabaacbabaaaaagaabaaaaaaaaaaaaoaaaaafacaeaaaaacaaaacaa
babbbbaabebbbaacbcbaabaalllllllllllaaaaaabbabacbabafbaaaaaabacaabeaaababaaaaaaacaajgfacaaaabeaaaaaaa
eaaabbaaabbgaaababaaaaabaalllllllllllabaaabbcbbbdbabaaaacbbaaaaaaacaaaaaaaaaabaaabagaabaaaaaaacacaaa
baaaabbbcabbabbababcaababaaaaallllllllllaababbbababbacaaaabagabaabbaaaabacaabaaajaaaaaadccaaaaaabaaa
baaaabbaaaabbabeeabbaaccababbbaabllllllllaaaaaabaacbaaeaaaacacbbbaaaaaabadaaabaaaacabbaaaabceaeaabba
bbadefbbbbabaaaaabbaabaaabbaaaabbaaallllllllaadaabbaaaaaaabaaaaaaaaaaabaaaabaacaaaaacaaaaaabacceeaaa
bbbabfbbaaeaabeaaaaabaaaaabcbbbaabaaabaallllllaaabbacacbaafbbaabaacaaaaecfaafaaaaaabaaacaaabaaacaeaa
baabbbbabaaaababagafabbabaaaaaaaababbacaaaallllaaaaaabaafaabaaabaaaaceaaabbacaaacaaacjeaacaajbaaacaa
bfbcbaebbbfbacabbababbabbbaaabacabaaaaaaaaaaalllaaaaaaaaacbaafaaaaaaabfaaaaaaaajaaaabababaacaaaabaaa
ababababbbbabaabbbbaabaaabbaabaaaafbbbaaabaaaaallabbaaacafacaaaaaaaaaaaeaacabaaamabcaabaaaaaacabaaaa
baaaaabbbbbbaadebacaaaabaabbbaaaacabbbabbbaaaaaallaaafaaaaacaaaafaaabcbafaaaaaacaaaaaaabcaaaaadaaaaa
baacaabbaabbbbbaaaaaaaabaaabbbaaababababbbafdaaaallaaafaaaacbceaaaafbaaabbbaabaaabaaacaaajcaaaaacaaa
babbbbbabacbbbbbababaecabbababbcabaaabbbcbbaaaaaalllbaaacaaabeaaaabcabaabcbcfaajabaaafaaaaaaabeaaaca
bbbbeaaeaaeabaababaaaaaabbagbbbaadbbfbaaababbbadaalllaaaaabbbaaaccaaabacaaaafecbbababaacaaaaacbacaaa
aaabaaaaaaaabababbbaaabaaaaeaeeabaaaabababababbaaalllaaaaaaaabcaaaaaacaaaaaabcaabbbcabbaacaaaaaabaca
ajeabbbbabbababeaabbababfaaabbbabaaaadaabacbbabaaaallaaafaaaacbaabaaaaaaaaacaaabbbbaaaebaaaaaaacaaae
aaabaaabeaaaaabbbabbabafacacbcbbgaabbbabbaeebbbabaalllabaaaaaaaaafaaabaaeaaaaaaacbbbacaaaaaacaaaaaaa
beaaabababjaaabbbebdabbbbababbbbabfbaabebaabbagbaaalllaaaaacaaafeabbaaaaacbaaafcabbbbaacjaaaaaaaacaa
fbaabbbaaaabebabbebaabbaaaaabbbbebfaaaabbbbbbbbbbaaalllaaaaaabecbbaaacaaabbbcaaaabbaaabaaaaabacaabaa
aaaababaaabbcbebabaabaeeaaabfbbbbbbgaacbbabbbbbabaaalllaaacaaaabbbaaacabaaacbdaaaaabcbabacbaaaababaa
abbabaeaaaabbabeaaebbbabababbfbbfbbbaababfaabbabaaaalllabbaaaaaebaeabaaaaceaaacaaaaabbacabbaacaababa
ecaaaaababaabababbaaaaaeaabbbefbbbbbbbaabbbbabbbabcallllabbaababcaabaaaaaabaaabaacabaacaaaaaaaaabbba
eababbbbaacabbabbabbbjbbabbbbaacbbbbbbaabcbbbbbbaaabblllabbcaaaaaabbbfbbaaaaacbaaaaaaeaabceabaacbbaa
aaaebabaaabaaabbaaaaaabbaaaaababbbbbbbbaababbbfcabbballlabbbbabbbabbabbaaaacaabacaaaaabaaaaaaaaaabaa
aeaaaabbaababdabbbabaababeaaabcabafbbeaabbbbbbbbbaabballlabbfababaabaabbaaaabbabaaacabaaaeacaacbaaaa
eacaaaaacbaabaabaaaaabaaababaabaabebabebabaabcbbbababblllabbcaabaabaacbaaaaaaaacbbbbaaacaaaaaaaacbaa
aaaabbbaababbaaabcabbaeabfbbbabbebbbabeaabaabbabbbbaaalllabbaaacababbaafccaacaaaafbaacaaabaabcbaaaaa
faaabbbaaaaaabaaaabbebbbbaaabfbbabbbabaabbbaaabbabbaabllllabaaaaabaaacabbaabbeaaabaacbaaacaaaaaaaaca
ababbbaaaacaaaacaaabbbbbbbaabcbbfaaabaaabbabbbabbaacaballllbaaaacaaccaaaaeacaaaabaaaabacaaaaaaaoaaba
aaabnbaacaaaacaaaaabaaaadaaabeaabbabbcbadbaabbbbbadaabbllllbbcaaabacfabccaaaabaaaaaaacaabaccaaaaaaba
aaabbaaaaaaaaaaaabbbbbaaaaaabbaabaaabbaabaacababaabaabballlabbadfbaaabbaaabaabbaaacaaaabaaaaacbaacaa
fcaaaaaaacaaaacaaaafbaaacbaaaaabbababbabbabaaaafaecaacaallllbbaaacabbaeaabbafbbabaadabbaaaaacaaaaaaa
aaaaacadaaeaaaaaaaacacaaaaaaaabaabbbcabgbbbaaaaaeaaaaaaallllabaaaabbcaaaaaabcbcaaaaabcabaaaaaaaaaaaa
afaaaaaaaaaaaaaaaaaaabaaaabadabcbaabbabbbbaabaaaaaaaacacpllllaaaaaababaaaaaaaaaaaaabaaaaacaaaacacbaa
aaaaaaaaabadaaaaaaaaaeabgaaaaaaaaaaafbbbabbbbbaaacaaaaaallallbaacafabbbcbcabbaabcafbaebaeaacaaaaaaaa
eaaaaabafaaaaaaaaaaaacabaabaaaaaaaaaaagabbbbabaaaaafaaalllalllbaaaaafabfaaaaabaaaaaacbaababaaaaaaaab
aaaacabbaaaaaaaabbaaaabaabbbaaaaaaabafaaebabbaeaafaaaabllafallaabbaabafbabacbaaafaaabaaaaaadacaaaaba
aaaaabbbcaacabbabbdcacbaabaaacaaaadabcaaabbbbeeacafacbbllaaaallabaaaaaccaadbcbaaafcaaaaaaoacaaacabaa
baafbbbbbaaabbagbbaabbdaaabbbaacabaffbabaabbebaaaaadaballacaalllbbcacabbbaaaaaabaabaaacaajaaaabaacaa
aacbbbbbbaadbgbabaaabbaaaabbaabbaaabaabacbbaebbbaaaaafallfaaablllaabaaafaababaaaabfaaaaaaaacacaaaaaa
eaabbbbbabbecabbacbbbabllllllllbbbbbbbbaaaabbbabaacaaalllabbbballlabbcaaacaaaacaacfacaaacaaaaaaaaaaa
aaabbbaaaacbaabbabaaallllaaalllllababbaaaacaaaaacaacbbllabbaafballlabbaaffababaffaaabacaaaaaacecbaaa
eaabbaaacabdaacgabaalllaaabeaalllllllaadaaaaaaaaaaabblllbaababbaallaabaaabebbbfbcabacaaaaacaebbaaaaa
aaaaaabaaaaaaagaaablllaabbafffaaalllllaabggaacaaaabblllbaaacbbbaaallaaacbaabbbaabaaacaaadaaaabaqbcaa
baaaaceabbaabbaaaaallaaefafbbbabaaalllllbbacgaaggcalllbbacaabaeeaallaaaaacaabbabbaaaaacacaaaacaeeaaa
baaaeeaaaaabbbbbdaalaacebebbbacbbbaalllllbbaaaacaaalllbaaabbbebaalllaaaaaaabbacaaacaaacaaaabaaabeaaa
bdcababacbagabbaballaaabbacabbbcaabaaaalllbbbbaaallllbacbabbaabaallaacaaabbaabaaabaacaaacabbaaaoacab
baabbaabbbabbbaaalllaaabbabaaaabaaaabbaalllaballlllabbbbbfbbabaaallabaaababacabaaabaaacacbeacaaabcaa
baabcaaabbbaacaaallacabbabbaabaaabcaabbaallllllllabbbdabfcbabbaallabaacabfaeaabacaaaaaabbacaabbaaaba
babbaaabgabbabaaalllaabbbbbbaaaabaabaabbaalllllabbbbabbffababaaallabbaaababeabbbaabaacaaceaaaabbabba
babaaaabbabbaabaaallaabbbacbbbcaabcabcbabbbaaabbbbbbfbfebabbbaallabbaabcbaaeabcbcbcaabbabaaacabaaaaa
baaabggbbabbbabraallacbabbbbaabbababbbbcbabbbbbabfbacebbcbbbcalllabbcbaaacdbababbaaacgaaaabaaacacbba
baaaaabbbbbbabbbballaababfbbabbbabbacababcbaebaffabebbabbbaaaallabbaaaaaaaaacbbbaecagbeaaaabcbaacbea
abaaaabbbbbaaabbaalllaacafbbdaababbbbbbbabbaababbbabbbbaaaaaaallabfaaaaaaaabbbacaaababacdaaaaacaeaea
abaceeebaabbacbaaallllaaaabfabbbbecaaacaaaaabbbaabbabaaaaacaallacaaaaaacaabbbbbaaaaacbaabcbabbbacbca
abaaebabbafcaabacaalllaacaabbfaabaeebbbbbabcaacbbacacacaaaalllabaaacbaadbaaabcbbcagaffcaaaabeaaaeaaa
baaababaacbaaabaaaaalllaaaaaabbbfacaaaaaaaaaabaadaaaaaaaaalllabbaaaabaaebaabaabbacbaabfacaaacbebabaa
bcabbbbbbbbaaaaaabaaallllcaacacabbabbabababaaaaaaaallllllllaabbbaacaacbaaabbcbcabbaaafbaaaaababaaaaa
baebbbbbbabeaaaaaaaaaallllaaaaaacaaacacacaaaaacallllllllllaabbbbadaaabaaabbbaaafaaababaaabcacbaacaaa
aaaabbbabbdebaacabaaaaalllllaaaaaaaaaaaaallllllllllaaabbaaabaaabaabaaabaaabbaagaaaaaacaabbabaacaaaaa
bababbffbbbabcafababaaslllllllacacallllllllllllllaabbbbbacfaaaacabacabbcabaababbbfbaebbcabaabaaaabab
baaababbafbabababaaaaacaallllllllllllllllaaaaaaaaabbbbbbbababaaaaaababbbbbbbbabbbabbbbaaabbabcabaabb
bebbbbbbaaaebbabacaaaaaaaaallllllllaaaabbbacaaaaacaabbabaacbdabebcaafabaaabaeaabbcbaaabdbbaaeaacbbaa
aaaabbabbbbabbagbgbbeaaabaaaallllaaaaabbbbaaacaaaaabaaaacaaaaaaaafbaaaaccabbaababaaaacacaaabaabajbaa
baacababbbbabbbbaabbbbaadaabbaaaaaaacabbbbaaaabaaaabababaaaabbababacbaaabbbaebbbaaacaaaaacaaabaajbaa
aaabacaadbabbbbbbbbgbbfaaabbbacaaaaaaabbaacaabbbbacafbbabaabbbcbaaabaaabdfabbaabababacbaaaacbbacbbab
aabaaababbbabbbcabbbbcabbbbbbaabaacaabcaaaabaabaafbaabbdbbbbabaadaaaacbaaabcaaababbbaaaabbaaacbbbjaa
aaaaaaacabababbfbbabababebbfbbaabaabcbbbbbbbbbbbabbababbabaaaabagbaaaababbabacbcbabcaaacaaaaabacaaaa
acbebaaaaacbbbbabbabbaabaaabaaaaaacababbabcbbabadbbebbbgaaaaaadabaaaaeaabaaabbaaafbaacbaacaadaaaacaa
facabbbaaabbbbababbbabcacabcaacaacabbaacabbaaaaabbaaabaacabaaabaabbbaaabaaaabaacbabgaaaeababbanaaaba
aajaaaabbbaabbbbbbeabbaabgabaaacabaaaaababagbbaabcabaaaabacababaaaacaaaabbbbbaaabaagdbacaaaaacaaaaaa
caaadaaaabaaacabbcababaaaabbbebeaabbaabbbbaaaaaaabbaaaaaaabafaaabbbaaaabcdaaaaafbcgaeaaaaabaaaacaaaa
aaaaafabbabaabbabbbbbebaababagaabbbbabbbbbbbbbbbcababacacababaaebaaabbajabaaacaabaaaabaaacaaaaaaacaa
aaaaaeaaaabaabacbdbbbbacabcbbbabaaabaaaaaabbbababaaaafadbaaaagabdbbaacaaaaaabaacaaacaaadaaacaaaaaaaa
aaaacaaaadaabbaaabbbbbbbebbaabbabbabbcabbaabbcbbabaaabbabbaacfefcaaaaaafacaabbbgaaaaacabacaaaaaaaaaa
aacaaaaaaafcaabaabaabbaaabafabbaaaeaaaaebaaaaaaaafaaacacabaaaaeaaaacaaabaaacabgaaacaaaacaaacacaaajaa
ccaacaaajebbaebbfbbceebebaebbbeebacbbbcfgbfeebbbbeebbaebbbaeaeeaaeaaabbebbbaabajajaaacjcacaaacacacaa
"}
